0111111111110
10010000000C1
1000011111001
1000110000001
0111111111110
