1111111111111
1001XX00000C1
1000011111XX1
1P0011E000001
1111111111111
